EA ./sources/textures/1.xpm
NO ./sources/textures/2.xpm
SO ./sources/textures/3.xpm
WE ./sources/textures/4.xpm
F 109,109,109
C 54,54,54

1111111111111111
111000000001111111111
1111110000000000011111111111111111111
    111111000000000000000000000000001111111111111
    111111111000000000011111111111111
11111000000000000000000000000001
100000000000N000000000000000001
10000000000000000000000000000001
10000000000111111111100000000001
100000000001        100000000001
10000000000111111111100000000001
10000000000000000000000000000001
11111111111111111111111111111111
